WWWWWWWWWWWWWWWWWWWW
WS     F           W
W      F           W
WFFFFF F           W
W      F           W
WF  FFFF           W
W  W               W
W                  W
WFFFFFF            W
W                  W
W S F  F           W
W FFF    F         W
W      EF          W
WFFFwwwwF          W
WFFFFFFFFFFFFFFFFFFW