WWWWWWWWWWWWWWWWWWWWWWWWWWWWWWWWWWWWWWWWWWWWWWWWWWWWWW
W                                                    W
W                                                    W
W                                                    W
W                                  FFFFFFFFFW        W
W                                           W        W
W                                           W        W
W       FFFFFFFFFFFFFFFFFF             W    W        W
W                                      W    W        W
WS                                     WE   W        W
W                      FFFFFFFFFFFFFFFFFFFFFF        W
WFFFFFFFFF                                           W
W                                                    W
W                                                    W
W                                                    W
W                                                    W
W                                                    W
W                                                    W
W                                                    W
W                                                    W
WwwwwwwwwwwwwwwwwwwwwwwwwwwwwwwwwwwwwwwwwwwwwwwwwwwwwW
WWWWWWWWWWWWWWWWWWWWWWWWWWWWWWWWWWWWWWWWWWWWWWWWWWWWWW