WWWWWWWWWWWWWWWWWWWWWWWWWWWWWWWWWWWWWWWWWWWWWWWWWWWWWW
WS                                                   W
W                                                    W
WFFFFFFFFFFFFFFFFFFFFFFF    FFFFFFFFFFFFFFFFFFFFFFFFFW
W                                                    W
W                                                    W
WFFFFFF  FFFFFFFFFFFFFFFFFFFFFFFFFFF  FFFFFFFFFFFFFFFW
W             W                                      W
W             W                                      W
WFF  FFFFFFFFFFFFFFFFFFFFFFFFFFFFFFFFFFFFFFFFFFFFFFFFW
W                                                    W
W                                                    W
WFFFFFFFFFFFFFFFFFFFFFFFFFFFFFFFFFFFFF  FFFFFFFFFFFFFW
W                                                    W
W                                                    W
WFFFFFF  FFFFFFFFFFF  FFFFFFFFFFFF  FFFFFFFFFFFFF  FFW
W                                                    W
W                                                    W
W              FFFFFFFFFFFFFFFFFFFFFFFF              W
W                                      F             W
W   FFFFFFFFFFFFF                       F            W
W                                                   EW
WWWWWWWWWWWWWWWWWWWWWWWWWWWWWWWWWWWWWWWWWWWWWWWWWWWWWW