WWWWWWWWWWWWWWWWWWWWWWWWWWWWWWWWWWWWWWWWWWWWWWWWWWWWWW
WS                                                   W
W                                                    W
WFFFFFFFFFFFFFFFFFFFFFFF    FFFFFFFFFFFFFF           W
W                           E                        W
W                                                    W
WFFFFFF  FFFFFFFFFFFFFFFFFFFFFFFFFFF  FFFFFFFFFFFFFFFW
W                                                   SW
W                                                    W
WFF  FFFFFFFFFFFFFFFFFFFFFFFFFFwwwwwwwwwwwFFFFFFFFFFFW
W                             FFFFFFFFFFFFF          W
W                                                    W
WFFFFFFFFFFFFFFFFFFFFFFFFFFFFFFFFFFFFF               W
W                                                    W
W                                                    W
W          FFFFFFFFFFFFFFFFFFFFFFFFFFFFFFFFwwwwwwwwFFW
W                                         FFFFFFFFFF W
W                                                    W
W     FFFFFFFFFFFFFFFFFFFFFFFFFFFFFFFFFFF            W
W              W                                     W
W  FFFFF       W              FFFFFFFFFFFFFFFF       W
W              WE                                    W
WWWWWWWWWWWWWWWWWWWWWWWWWWWWWWWWWWWWWWWWWWWWWWWWWWWWWW